00000000
01000100
00000000
00000000
00000000
01100100
00000000
00000000
10100110
00000000
00000000
00000000
11101000
00010000
00000000
00000001
00101010
00011000
00000000
00000001
01101100
00000000
00000000
00000001
10101110
00000000
00000000
10100000